agresywnego krwiopijcy|agresywnego krwiopijcę|agresywnemu krwiopijcy|agresywni krwiopijcy|agresywny krwiopijca|agresywny krwiopijco|agresywnych krwiopijcach|agresywnych krwiopijców|agresywnym krwiopijcom|agresywnym krwiopijcy|agresywnym krwiopijcą|agresywnymi krwiopijcami
aligator|aligatora|aligatorach|aligatorami|aligatorem|aligatorom|aligatorowi|aligatory|aligatorze|aligatorów
arcykapłan|arcykapłana|arcykapłanach|arcykapłanami|arcykapłanem|arcykapłani|arcykapłanie|arcykapłanom|arcykapłanowi|arcykapłanów
bagienne golemy|bagiennego golema|bagiennemu golemowi|bagienny golem|bagienny golemie|bagiennych golemach|bagiennych golemów|bagiennym golemem|bagiennym golemie|bagiennym golemom|bagiennymi golemami
bagienne szczury|bagiennego szczura|bagiennemu szczurowi|bagienny szczur|bagienny szczurze|bagiennych szczurach|bagiennych szczurów|bagiennym szczurem|bagiennym szczurom|bagiennym szczurze|bagiennymi szczurami
bagienne trutnie|bagiennego trutnia|bagiennemu trutniowi|bagienny truteń|bagienny trutniu|bagiennych trutni|bagiennych trutniach|bagiennym trutniem|bagiennym trutniom|bagiennym trutniu|bagiennymi trutniami
trutnie|trutnia|trutniowi|truteń|trutniu|trutni|trutniach|trutniem|trutniom|trutniu|trutniami
bagienne zombie|bagiennego zombie|bagiennemu zombie|bagienny zombie|bagiennych zombie|bagiennym zombie|bagiennymi zombie
baran|barana|baranach|baranami|baranem|baranie|baranom|baranowi|barany|baranów
brzytw|brzytwa|brzytwach|brzytwami|brzytwie|brzytwo|brzytwom|brzytwy|brzytwą|brzytwę
brzytwiak|brzytwiaka|brzytwiakach|brzytwiakami|brzytwiaki|brzytwiakiem|brzytwiakom|brzytwiakowi|brzytwiaku|brzytwiaków
błędne ogniki|błędnego ognika|błędnemu ognikowi|błędny ognik|błędny ogniku|błędnych ognikach|błędnych ogników|błędnym ognikiem|błędnym ognikom|błędnym ogniku|błędnymi ognikami
chrząszcz|chrząszcza|chrząszczach|chrząszczami|chrząszcze|chrząszczem|chrząszczom|chrząszczowi|chrząszczu|chrząszczy
cieniostwora|cieniostworach|cieniostworami|cieniostworem|cieniostworom|cieniostworowi|cieniostwory|cieniostworze|cieniostworów|cieniostwór
czarne gobliny|czarnego goblina|czarnemu goblinowi|czarny goblin|czarny goblinie|czarnych goblinach|czarnych goblinów|czarnym goblinem|czarnym goblinie|czarnym goblinom|czarnymi goblinami
czarne trolle|czarnego trolla|czarnemu trollowi|czarny troll|czarny trollu|czarnych trollach|czarnych trolli|czarnym trollem|czarnym trollom|czarnym trollu|czarnymi trollami
czarne wilki|czarnego wilka|czarnemu wilkowi|czarny wilk|czarny wilku|czarnych wilkach|czarnych wilków|czarnym wilkiem|czarnym wilkom|czarnym wilku|czarnymi wilkami
demon|demona|demonach|demonami|demonem|demonie|demonom|demonowi|demony|demonów
demon ognia|demona ognia|demonach ognia|demonami ognia|demonem ognia|demonie ognia|demonom ognia|demonowi ognia|demony ognia|demonów ognia
dzik|dzika|dzikach|dzikami|dziki|dzikiem|dzikom|dzikowi|dziku|dzików
elitarni orkowie|elitarnych orkach|elitarnych orków|elitarnym orkom|elitarnymi orkami
golem mostowy|golema mostowego|golemach mostowych|golemami mostowymi|golemem mostowym|golemie mostowy|golemie mostowym|golemom mostowym|golemowi mostowemu|golemy mostowe|golemów mostowych
gwardzista ork|gwardzistach orkach|gwardzistami orkami|gwardzisto orku|gwardzistom orków|gwardzisty orka|gwardzistów orków|gwardzistą orkiem|gwardzistę orka|gwardziści orków|gwardziście orkowi|gwardziście orku
jaszczur|jaszczura|jaszczurach|jaszczurami|jaszczurem|jaszczurom|jaszczurowi|jaszczury|jaszczurze|jaszczurów
kamiennego strażnika|kamiennemu strażnikowi|kamienni strażnicy|kamienny strażnik|kamienny strażniku|kamiennych strażnikach|kamiennych strażników|kamiennym strażnikiem|kamiennym strażnikom|kamiennym strażniku|kamiennymi strażnikami
kretoszczur|kretoszczura|kretoszczurach|kretoszczurami|kretoszczurem|kretoszczurom|kretoszczurowi|kretoszczury|kretoszczurze|kretoszczurów
królowa pełzaczy|królowe pełzaczy|królowej pełzaczy|królowo pełzaczy|królowych pełzaczy|królowym pełzaczy|królowymi pełzaczy|królową pełzaczy
krwawe ogary|krwawego ogara|krwawemu ogarowi|krwawy ogar|krwawy ogarze|krwawych ogarach|krwawych ogarów|krwawym ogarem|krwawym ogarom|krwawym ogarze|krwawymi ogarami
krwiopijca|krwiopijcach|krwiopijcami|krwiopijco|krwiopijcom|krwiopijcy|krwiopijców|krwiopijcą|krwiopijcę
książąt demonów|książę demonów|książęta demonów|książętach demonów|książętami demonów|książętom demonów|księcia demonów|księciem demonów|księciu demonów
kąsacz|kąsacza|kąsaczach|kąsaczami|kąsacze|kąsaczem|kąsaczom|kąsaczowi|kąsaczu|kąsaczy
latające roje|latającego roju|latającemu rojowi|latający roju|latający rój|latających rojach|latających rojów|latającym rojem|latającym rojom|latającym roju|latającymi rojami
lodowe golemy|lodowego golema|lodowemu golemowi|lodowy golem|lodowy golemie|lodowych golemach|lodowych golemów|lodowym golemem|lodowym golemie|lodowym golemom|lodowymi golemami
lodowe wilki|lodowego wilka|lodowemu wilkowi|lodowy wilk|lodowy wilku|lodowych wilkach|lodowych wilków|lodowym wilkiem|lodowym wilkom|lodowym wilku|lodowymi wilkami
magiczne golemy|magicznego golema|magicznemu golemowi|magiczny golem|magiczny golemie|magicznych golemach|magicznych golemów|magicznym golemem|magicznym golemie|magicznym golemom|magicznymi golemami
mali krwiopijcy|małego krwiopijcy|małego krwiopijcę|małemu krwiopijcy|mały krwiopijca|mały krwiopijco|małych krwiopijcach|małych krwiopijców|małym krwiopijcom|małym krwiopijcy|małym krwiopijcą|małymi krwiopijcami
młoda polna bestia|młoda polna bestio|młode polne bestie|młodej polnej bestii|młodych polnych bestiach|młodych polnych bestii|młodym polnym bestiom|młodymi polnymi bestiami|młodą polną bestią|młodą polną bestię
młode kretoszczury|młodego kretoszczura|młodemu kretoszczurowi|młody kretoszczur|młody kretoszczurze|młodych kretoszczurach|młodych kretoszczurów|młodym kretoszczurem|młodym kretoszczurom|młodym kretoszczurze|młodymi kretoszczurami
młode olbrzymie szczury|młodego olbrzymiego szczura|młodemu olbrzymiemu szczurowi|młody olbrzymi szczur|młody olbrzymi szczurze|młodych olbrzymich szczurach|młodych olbrzymich szczurów|młodym olbrzymim szczurem|młodym olbrzymim szczurom|młodym olbrzymim szczurze|młodymi olbrzymimi szczurami
młode trolle|młodego trolla|młodemu trollowi|młody troll|młody trollu|młodych trollach|młodych trolli|młodym trollem|młodym trollom|młodym trollu|młodymi trollami
młode wilki|młodego wilka|młodemu wilkowi|młody wilk|młody wilku|młodych wilkach|młodych wilków|młodym wilkiem|młodym wilkom|młodym wilku|młodymi wilkami
młode ścierwojady|młodego ścierwojada|młodemu ścierwojadowi|młody ścierwojad|młody ścierwojadzie|młodych ścierwojadach|młodych ścierwojadów|młodym ścierwojadem|młodym ścierwojadom|młodym ścierwojadzie|młodymi ścierwojadami
ogar|ogara|ogarach|ogarami|ogarem|ogarom|ogarowi|ogary|ogarze|ogarów
ognik|ognika|ognikach|ognikami|ogniki|ognikiem|ognikom|ognikowi|ogniku|ogników
ogniste demony|ognistego demona|ognistemu demonowi|ognisty demon|ognisty demonie|ognistych demonach|ognistych demonów|ognistym demonem|ognistym demonie|ognistym demonom|ognistymi demonami
ogniste golemy|ognistego golema|ognistemu golemowi|ognisty golem|ognisty golemie|ognistych golemach|ognistych golemów|ognistym golemem|ognistym golemie|ognistym golemom|ognistymi golemami
ogniste jaszczury|ognistego jaszczura|ognistemu jaszczurowi|ognisty jaszczur|ognisty jaszczurze|ognistych jaszczurach|ognistych jaszczurów|ognistym jaszczurem|ognistym jaszczurom|ognistym jaszczurze|ognistymi jaszczurami
ogniste smoki|ognistego smoka|ognistemu smokowi|ognisty smok|ognisty smoku|ognistych smokach|ognistych smoków|ognistym smokiem|ognistym smokom|ognistym smoku|ognistymi smokami
olbrzymi szczur|olbrzymi szczurze|olbrzymich szczurach|olbrzymich szczurów|olbrzymie szczury|olbrzymiego szczura|olbrzymiemu szczurowi|olbrzymim szczurem|olbrzymim szczurom|olbrzymim szczurze|olbrzymimi szczurami
opiekun świątyni|opiekuna świątyni|opiekunach świątyni|opiekunami świątyni|opiekunem świątyni|opiekunie świątyni|opiekunom świątyni|opiekunowi świątyni|opiekunowie świątyni|opiekunów świątyni
opiekunach świątyni|opiekunami świątyni|opiekunom świątyni|opiekunowie świątyni|opiekunów świątyni
ork|orka|orkach|orkami|orkiem|orkom|orkowi|orkowie|orku|orków
ork myśliwy|orka myśliwego|orkach myśliwych|orkami myśliwymi|orkiem myśliwym|orkom myśliwym|orkowi myśliwemu|orkowie myśliwi|orku myśliwy|orku myśliwym|orków myśliwych
ork niewolnik|orka niewolnika|orkach niewolnikach|orkami niewolnikami|orkiem niewolnikiem|orkom niewolnikom|orkowi niewolnikowi|orkowie niewolnicy|orku niewolniku|orków niewolników
ork pułkownik z wyspy irdorath|orka pułkownika z wyspy irdorath|orkach pułkownikach z wyspy irdorath|orkami pułkownikami z wyspy irdorath|orkiem pułkownikiem z wyspy irdorath|orkom pułkownikom z wyspy irdorath|orkowi pułkownikowi z wyspy irdorath|orkowie pułkownicy z wyspy irdorath|orku pułkowniku z wyspy irdorath|orków pułkowników z wyspy irdorath
ork pułkownik z wyspy khorinis|orka pułkownika z wyspy khorinis|orkach pułkownikach z wyspy khorinis|orkami pułkownikami z wyspy khorinis|orkiem pułkownikiem z wyspy khorinis|orkom pułkownikom z wyspy khorinis|orkowi pułkownikowi z wyspy khorinis|orkowie pułkownicy z wyspy khorinis|orku pułkowniku z wyspy khorinis|orków pułkowników z wyspy khorinis
ork strażnik|orka strażnika|orkach strażnikach|orkami strażnikami|orkiem strażnikiem|orkom strażnikom|orkowi strażnikowi|orkowie strażnicy|orku strażniku|orków strażników
ork szaman|orka szamana|orkach szamanach|orkami szamanami|orkiem szamanem|orkom szamanom|orkowi szamanowi|orkowie szamani|orku szamanie|orków szamanów|szaman|szamana|szamanach|szamanami|szamanem|szamanom|szamanowi|szamani|szamanie|szamanów|ork-szaman|orka-szamana|orkach-szamanach|orkami-szamanami|orkiem-szamanem|orkom-szamanom|orkowi-szamanowi|orkowie-szamani|orku-szamanie|orków-szamanów
ork wiarus|orka wiarusa|orkach wiarusach|orkami wiarusami|orkiem wiarusem|orkom wiarusom|orkowi wiarusowi|orkowie wiarusi|orku wiarusie|orków wiarusów
ork wojownik|orka wojownika|orkach wojownikach|orkami wojownikami|orkiem wojownikiem|orkom wojownikom|orkowi wojownikowi|orkowie wojownicy|orku wojowniku|orków wojowników
ork zwiadowca|orka zwiadowcy|orka zwiadowcę|orkach zwiadowcach|orkami zwiadowcami|orkiem zwiadowcą|orkom zwiadowcom|orkowi zwiadowcy|orkowie zwiadowcy|orku zwiadowco|orku zwiadowcy|orków zwiadowców
ork żołnierz|orka żołnierza|orkach żołnierzach|orkami żołnierzami|orkiem żołnierzem|orkom żołnierzom|orkowi żołnierzowi|orkowie żołnierze|orku żołnierzu|orków żołnierzy
ork-elita|orka-elity|orka-elitę|orkach-elitach|orkami-elitami|orkiem-elitą|orkom-elitom|orkowi-elicie|orkowie-elity|orku-elicie|orku-elito|orków-elit
ork-ożywieniec|orka-ożywieńca|orkach-ożywieńcach|orkami-ożywieńcami|orkiem-ożywieńcem|orkom-ożywieńcom|orkowi-ożywieńcowi|orkowie-ożywieńcy|orku-ożywieńcu|orków-ożywieńców
ork-wojownik|orka-wojownika|orkach-wojownikach|orkami-wojownikami|orkiem-wojownikiem|orkom-wojownikom|orkowi-wojownikowi|orkowie-wojownicy|orku-wojowniku|orków-wojowników
ork-zwiadowca|orka-zwiadowcy|orka-zwiadowcę|orkach-zwiadowcach|orkami-zwiadowcami|orkiem-zwiadowcą|orkom-zwiadowcom|orkowi-zwiadowcy|orkowie-zwiadowcy|orku-zwiadowco|orku-zwiadowcy|orków-zwiadowców
orkach niewolnikach|orkami niewolnikami|orkom niewolnikom|orkowie niewolnicy|orków niewolników
orkowe psy|orkowego psa|orkowemu psu|orkowy pies|orkowy psie|orkowych psach|orkowych psów|orkowym psem|orkowym psie|orkowym psom|orkowymi psami
owca|owcach|owcami|owce|owco|owcom|owcy|owcą|owcę|owiec
ożywieni Bloodwynowie|ożywionego Bloodwyna|ożywionemu Bloodwynowi|ożywiony Bloodwyn|ożywiony Bloodwynie|ożywionych Bloodwynach|ożywionych Bloodwynów|ożywionym Bloodwynem|ożywionym Bloodwynie|ożywionym Bloodwynom|ożywionymi Bloodwynami
panter|pantera|panterach|panterami|pantero|panterom|pantery|panterze|panterą|panterę
pełzacz|pełzacza|pełzaczach|pełzaczami|pełzacze|pełzaczem|pełzaczom|pełzaczowi|pełzaczu|pełzaczy|pełzaczę
pomniejsze szkielety|pomniejszego szkieleta|pomniejszego szkieletu|pomniejszemu szkieletowi|pomniejszy szkielecie|pomniejszy szkielet|pomniejszych szkieletach|pomniejszych szkieletów|pomniejszym szkielecie|pomniejszym szkieletem|pomniejszym szkieletom|pomniejszymi szkieletami
preriowe ścierwojady|preriowego ścierwojada|preriowemu ścierwojadowi|preriowy ścierwojad|preriowy ścierwojadzie|preriowych ścierwojadach|preriowych ścierwojadów|preriowym ścierwojadem|preriowym ścierwojadom|preriowym ścierwojadzie|preriowymi ścierwojadami
prychające smocze zębacze|prychającego smoczego zębacza|prychającemu smoczemu zębaczowi|prychający smoczy zębacz|prychający smoczy zębaczu|prychających smoczych zębaczach|prychających smoczych zębaczy|prychającym smoczym zębaczem|prychającym smoczym zębaczom|prychającym smoczym zębaczu|prychającymi smoczymi zębaczami
przywódca grupy|przywódcach grup|przywódcami grup|przywódco grupy|przywódcom grup|przywódcy grup|przywódcy grupy|przywódców grup|przywódcą grupy|przywódcę grupy
przywołane błotniaki|przywołanego błotniaka|przywołanemu błotniakowi|przywołany błotniak|przywołany błotniaku|przywołanych błotniakach|przywołanych błotniaków|przywołanym błotniakiem|przywołanym błotniakom|przywołanym błotniaku|przywołanymi błotniakami
przywołanego kamiennego strażnika|przywołanemu kamiennemu strażnikowi|przywołani kamienni strażnicy|przywołany kamienny strażnik|przywołany kamienny strażniku|przywołanych kamiennych strażnikach|przywołanych kamiennych strażników|przywołanym kamiennym strażnikiem|przywołanym kamiennym strażnikom|przywołanym kamiennym strażniku|przywołanymi kamiennymi strażnikami
przywołane zombie|przywołanego zombie|przywołanemu zombie|przywołany zombie|przywołanych zombie|przywołanym zombie|przywołanymi zombie
przyzwane szkielety|przyzwanego szkieleta|przyzwanego szkieletu|przyzwanemu szkieletowi|przyzwany szkielecie|przyzwany szkielet|przyzwanych szkieletach|przyzwanych szkieletów|przyzwanym szkielecie|przyzwanym szkieletem|przyzwanym szkieletom|przyzwanymi szkieletami
pustynne szczury|pustynnego szczura|pustynnemu szczurowi|pustynny szczur|pustynny szczurze|pustynnych szczurach|pustynnych szczurów|pustynnym szczurem|pustynnym szczurom|pustynnym szczurze|pustynnymi szczurami
szczury|szczura|szczurowi|szczur|szczurze|szczurach|szczurów|szczurem|szczurom|szczurze|szczurami
ranne węże błotne|rannego węża błotnego|rannemu wężowi błotnemu|ranny wąż błotny|ranny wężu błotny|rannych wężach błotnych|rannych węży błotnych|rannym wężem błotnym|rannym wężom błotnym|rannym wężu błotnym|rannymi wężami błotnymi
smocze zębacze|smoczego zębacza|smoczemu zębaczowi|smoczy zębacz|smoczy zębaczu|smoczych zębaczach|smoczych zębaczy|smoczym zębaczem|smoczym zębaczom|smoczym zębaczu|smoczymi zębaczami
smok-ożywieniec|smoka-ożywieńca|smokach-ożywieńcach|smokami-ożywieńcami|smoki-ożywieńce|smokiem-ożywieńcem|smokom-ożywieńcom|smokowi-ożywieńcowi|smoku-ożywieńcu|smoków-ożywieńców
starsi opiekunowie świątyni|starszych opiekunach świątyni|starszych opiekunów świątyni|starszym opiekunom świątyni|starszymi opiekunami świątyni
starsi opiekunowie świątyni|starszego opiekuna świątyni|starszemu opiekunowi świątyni|starszy opiekun świątyni|starszy opiekunie świątyni|starszych opiekunach świątyni|starszych opiekunów świątyni|starszym opiekunem świątyni|starszym opiekunie świątyni|starszym opiekunom świątyni|starszymi opiekunami świątyni
strażnicy krypty|strażnikach krypty|strażnikami krypty|strażnikom krypty|strażników krypty
strażnicy orków|strażnikach orków|strażnikami orków|strażnikom orków|strażników orków
strażnicy krypty|strażnik krypty|strażnika krypty|strażnikach krypty|strażnikami krypty|strażnikiem krypty|strażnikom krypty|strażnikowi krypty|strażniku krypty|strażników krypty
szamanach orków|szamanami orków|szamani orków|szamanom orków|szamanów orków
szkielecie|szkielet|szkieleta|szkieletach|szkieletami|szkieletem|szkieletom|szkieletowi|szkieletu|szkielety|szkieletów
szkielecie cieniostworze|szkielet cieniostwór|szkieleta cieniostwora|szkieletach cieniostworach|szkieletami cieniostworami|szkieletem cieniostworem|szkieletom cieniostworom|szkieletowi cieniostworowi|szkieletu cieniostwora|szkielety cieniostwory|szkieletów cieniostworów
szkielecie goblinie|szkielet goblin|szkieleta goblina|szkieletach goblinach|szkieletami goblinami|szkieletem goblinem|szkieletom goblinom|szkieletowi goblinowi|szkieletu goblina|szkielety gobliny|szkieletów goblinów
szkielecie magu|szkielet mag|szkielet maga|szkieleta maga|szkieletach magach|szkieletami magami|szkieletem magiem|szkieletom magom|szkieletowi magowi|szkieletu maga|szkielety magowie|szkielety magów|szkieletów magów
szkielecie magu z wieży mgieł|szkielet maga z wieży mgieł|szkieleta maga z wieży mgieł|szkieletach magach z wieży mgieł|szkieletami magami z wieży mgieł|szkieletem magiem z wieży mgieł|szkieletom magom z wieży mgieł|szkieletowi magowi z wieży mgieł|szkieletu maga z wieży mgieł|szkielety magów z wieży mgieł|szkieletów magów z wieży mgieł
szkielecie wojowniku|szkielet wojownik|szkielet wojownika|szkieleta wojownika|szkieletach wojownikach|szkieletami wojownikami|szkieletem wojownikiem|szkieletom wojownikom|szkieletowi wojownikowi|szkieletu wojownika|szkielety wojownicy|szkielety wojowników|szkieletów wojowników
szkielecie zwiadowco|szkielecie zwiadowcy|szkielet zwiadowca|szkielet zwiadowcę|szkieleta zwiadowcy|szkieletach zwiadowcach|szkieletami zwiadowcami|szkieletem zwiadowcą|szkieletom zwiadowcom|szkieletowi zwiadowcy|szkieletu zwiadowcy|szkielety zwiadowcy|szkielety zwiadowców|szkieletów zwiadowców
słudze kruka|słudzy kruka|sług kruka|sługa kruka|sługach kruka|sługami kruka|sługi kruka|sługo kruka|sługom kruka|sługą kruka|sługę kruka
topielca|topielcach|topielcami|topielce|topielcem|topielcom|topielcowi|topielcu|topielców|topielec
topielca spod tamy|topielcach spod tamy|topielcami spod tamy|topielce spod tamy|topielcem spod tamy|topielcom spod tamy|topielcowi spod tamy|topielcu spod tamy|topielców spod tamy|topielec spod tamy
goblin|goblina|goblinach|goblinami|goblinem|goblinie|goblinom|goblinowi|gobliny|goblinów
goblin wojownik|goblina wojownika|goblinach wojownikach|goblinami wojownikami|goblinem wojownikiem|goblinie wojowniku|goblinom wojownikom|goblinowi wojownikowi|gobliny wojownicy|goblinów wojowników
goblińscy wojownicy|gobliński wojownik|gobliński wojowniku|goblińskich wojownikach|goblińskich wojowników|goblińskiego wojownika|goblińskiemu wojownikowi|goblińskim wojownikiem|goblińskim wojownikom|goblińskim wojowniku|goblińskimi wojownikami
golem|golema|golemach|golemami|golemem|golemie|golemom|golemowi|golemy|golemów
hersztach orków|hersztami orków|herszci orków|hersztom orków|hersztów orków
herszcie orków|herszt orków|herszta orków|hersztach orków|hersztami orków|hersztem orków|hersztom orków|hersztowi orków|hersztowie orków|hersztów orków
troll|trolla|trollach|trollami|trolle|trollem|trolli|trollom|trollowi|trollu
troll jaskiniowy|trolla jaskiniowego|trollach jaskiniowych|trollami jaskiniowymi|trolle jaskiniowe|trollem jaskiniowym|trolli jaskiniowych|trollom jaskiniowym|trollowi jaskiniowemu|trollu jaskiniowy|trollu jaskiniowym
warg|warga|wargach|wargami|wargi|wargiem|wargom|wargowi|wargu|wargów
wiarusach orków|wiarusami orków|wiarusi orków|wiarusom orków|wiarusów orków
wilk|wilka|wilkach|wilkami|wilki|wilkiem|wilkom|wilkowi|wilku|wilków
wodza hordy|wodzach hord|wodzami hord|wodzem hordy|wodzom hord|wodzowi hordy|wodzowie hord|wodzu hordy|wodzów hord|wódz hordy
wojownicy orków|wojownikach orków|wojownikami orków|wojownikom orków|wojowników orków
wojownicy cienia|wojownik cienia|wojownika cienia|wojownikach cienia|wojownikami cienia|wojownikiem cienia|wojownikom cienia|wojownikowi cienia|wojowniku cienia|wojowników cienia
wąż błotny|węża błotnego|wężach błotnych|wężami błotnymi|węże błotne|wężem błotnym|wężom błotnym|wężowi błotnemu|wężu błotny|wężu błotnym|węży błotnych
zombi
zombie
zwiadowcach orków|zwiadowcami orków|zwiadowcom orków|zwiadowcy orków|zwiadowców orków
zębacz|zębacza|zębaczach|zębaczami|zębacze|zębaczem|zębaczom|zębaczowi|zębaczu|zębaczy
ścierwojad|ścierwojada|ścierwojadach|ścierwojadami|ścierwojadem|ścierwojadom|ścierwojadowi|ścierwojady|ścierwojadzie|ścierwojadów
żołnierzach orków|żołnierzami orków|żołnierze orków|żołnierzom orków|żołnierzy orków
świątynne pełzacze|świątynnego pełzacza|świątynnemu pełzaczowi|świątynny pełzacz|świątynny pełzaczu|świątynnych pełzaczach|świątynnych pełzaczy|świątynnym pełzaczem|świątynnym pełzaczom|świątynnym pełzaczu|świątynnymi pełzaczami
jaszczuroczłek|jaszczuroczłeka|jaszczuroczłekach|jaszczuroczłekami|jaszczuroczłekiem|jaszczuroczłekom|jaszczuroczłekowi|jaszczuroczłekowie|jaszczuroczłeku|jaszczuroczłeków|jaszczuroludzi|jaszczuroludziach|jaszczuroludzie|jaszczuroludziom|jaszczuroludźmi
kamienne golemy|kamiennego golema|kamiennemu golemowi|kamienny golem|kamienny golemie|kamiennych golemach|kamiennych golemów|kamiennym golemem|kamiennym golemie|kamiennym golemom|kamiennymi golemami
pełzacz wojownik|pełzacza wojownika|pełzaczach wojownikach|pełzaczami wojownikami|pełzacze wojownicy|pełzaczem wojownikiem|pełzaczom wojownikom|pełzaczowi wojownikowi|pełzaczu wojowniku|pełzaczy wojowników
polna bestia|polna bestio|polne bestie|polnej bestii|polnych bestiach|polnych bestii|polnym bestiom|polnymi bestiami|polną bestią|polną bestię
polne pełzacze|polnego pełzacza|polnemu pełzaczowi|polny pełzacz|polny pełzaczu|polnych pełzaczach|polnych pełzaczy|polnym pełzaczem|polnym pełzaczom|polnym pełzaczu|polnymi pełzaczami
pomniejsze demony|pomniejszego demona|pomniejszemu demonowi|pomniejszy demon|pomniejszy demonie|pomniejszych demonach|pomniejszych demonów|pomniejszym demonem|pomniejszym demonie|pomniejszym demonom|pomniejszymi demonami
przyzwane wilki|przyzwanego wilka|przyzwanemu wilkowi|przyzwany wilk|przyzwany wilku|przyzwanych wilkach|przyzwanych wilków|przyzwanym wilkiem|przyzwanym wilkom|przyzwanym wilku|przyzwanymi wilkami
smoki|smoka|smokowi|smok|smoku|smokach|smoków|smokiem|smokom|smoku|smokami
